backbone.conv1.conv1.conv.weight                            	backbone.bottom_up.stem.conv1.weight                        	
backbone.conv1.conv1.norm.weight                            	backbone.bottom_up.stem.conv1.norm.weight                   	
backbone.conv1.conv1.norm.bias                              	backbone.bottom_up.stem.conv1.norm.bias                     	
backbone.conv1.conv1.norm._mean                             	backbone.bottom_up.stem.conv1.norm.running_mean             	
backbone.conv1.conv1.norm._variance                         	backbone.bottom_up.stem.conv1.norm.running_var              	
backbone.res2.res2a.branch2a.conv.weight                    	backbone.bottom_up.res2.0.conv1.weight                      	
backbone.res2.res2a.branch2a.norm.weight                    	backbone.bottom_up.res2.0.conv1.norm.weight                 	
backbone.res2.res2a.branch2a.norm.bias                      	backbone.bottom_up.res2.0.conv1.norm.bias                   	
backbone.res2.res2a.branch2a.norm._mean                     	backbone.bottom_up.res2.0.conv1.norm.running_mean           	
backbone.res2.res2a.branch2a.norm._variance                 	backbone.bottom_up.res2.0.conv1.norm.running_var            	
backbone.res2.res2a.branch2b.conv.weight                    	backbone.bottom_up.res2.0.conv2.weight                      	
backbone.res2.res2a.branch2b.norm.weight                    	backbone.bottom_up.res2.0.conv2.norm.weight                 	
backbone.res2.res2a.branch2b.norm.bias                      	backbone.bottom_up.res2.0.conv2.norm.bias                   	
backbone.res2.res2a.branch2b.norm._mean                     	backbone.bottom_up.res2.0.conv2.norm.running_mean           	
backbone.res2.res2a.branch2b.norm._variance                 	backbone.bottom_up.res2.0.conv2.norm.running_var            	
backbone.res2.res2a.branch2c.conv.weight                    	backbone.bottom_up.res2.0.conv3.weight                      	
backbone.res2.res2a.branch2c.norm.weight                    	backbone.bottom_up.res2.0.conv3.norm.weight                 	
backbone.res2.res2a.branch2c.norm.bias                      	backbone.bottom_up.res2.0.conv3.norm.bias                   	
backbone.res2.res2a.branch2c.norm._mean                     	backbone.bottom_up.res2.0.conv3.norm.running_mean           	
backbone.res2.res2a.branch2c.norm._variance                 	backbone.bottom_up.res2.0.conv3.norm.running_var            	
backbone.res2.res2a.short.conv.weight                       	backbone.bottom_up.res2.0.shortcut.weight                   	
backbone.res2.res2a.short.norm.weight                       	backbone.bottom_up.res2.0.shortcut.norm.weight              	
backbone.res2.res2a.short.norm.bias                         	backbone.bottom_up.res2.0.shortcut.norm.bias                	
backbone.res2.res2a.short.norm._mean                        	backbone.bottom_up.res2.0.shortcut.norm.running_mean        	
backbone.res2.res2a.short.norm._variance                    	backbone.bottom_up.res2.0.shortcut.norm.running_var         	
backbone.res2.res2b.branch2a.conv.weight                    	backbone.bottom_up.res2.1.conv1.weight                      	
backbone.res2.res2b.branch2a.norm.weight                    	backbone.bottom_up.res2.1.conv1.norm.weight                 	
backbone.res2.res2b.branch2a.norm.bias                      	backbone.bottom_up.res2.1.conv1.norm.bias                   	
backbone.res2.res2b.branch2a.norm._mean                     	backbone.bottom_up.res2.1.conv1.norm.running_mean           	
backbone.res2.res2b.branch2a.norm._variance                 	backbone.bottom_up.res2.1.conv1.norm.running_var            	
backbone.res2.res2b.branch2b.conv.weight                    	backbone.bottom_up.res2.1.conv2.weight                      	
backbone.res2.res2b.branch2b.norm.weight                    	backbone.bottom_up.res2.1.conv2.norm.weight                 	
backbone.res2.res2b.branch2b.norm.bias                      	backbone.bottom_up.res2.1.conv2.norm.bias                   	
backbone.res2.res2b.branch2b.norm._mean                     	backbone.bottom_up.res2.1.conv2.norm.running_mean           	
backbone.res2.res2b.branch2b.norm._variance                 	backbone.bottom_up.res2.1.conv2.norm.running_var            	
backbone.res2.res2b.branch2c.conv.weight                    	backbone.bottom_up.res2.1.conv3.weight                      	
backbone.res2.res2b.branch2c.norm.weight                    	backbone.bottom_up.res2.1.conv3.norm.weight                 	
backbone.res2.res2b.branch2c.norm.bias                      	backbone.bottom_up.res2.1.conv3.norm.bias                   	
backbone.res2.res2b.branch2c.norm._mean                     	backbone.bottom_up.res2.1.conv3.norm.running_mean           	
backbone.res2.res2b.branch2c.norm._variance                 	backbone.bottom_up.res2.1.conv3.norm.running_var            	
backbone.res2.res2c.branch2a.conv.weight                    	backbone.bottom_up.res2.2.conv1.weight                      	
backbone.res2.res2c.branch2a.norm.weight                    	backbone.bottom_up.res2.2.conv1.norm.weight                 	
backbone.res2.res2c.branch2a.norm.bias                      	backbone.bottom_up.res2.2.conv1.norm.bias                   	
backbone.res2.res2c.branch2a.norm._mean                     	backbone.bottom_up.res2.2.conv1.norm.running_mean           	
backbone.res2.res2c.branch2a.norm._variance                 	backbone.bottom_up.res2.2.conv1.norm.running_var            	
backbone.res2.res2c.branch2b.conv.weight                    	backbone.bottom_up.res2.2.conv2.weight                      	
backbone.res2.res2c.branch2b.norm.weight                    	backbone.bottom_up.res2.2.conv2.norm.weight                 	
backbone.res2.res2c.branch2b.norm.bias                      	backbone.bottom_up.res2.2.conv2.norm.bias                   	
backbone.res2.res2c.branch2b.norm._mean                     	backbone.bottom_up.res2.2.conv2.norm.running_mean           	
backbone.res2.res2c.branch2b.norm._variance                 	backbone.bottom_up.res2.2.conv2.norm.running_var            	
backbone.res2.res2c.branch2c.conv.weight                    	backbone.bottom_up.res2.2.conv3.weight                      	
backbone.res2.res2c.branch2c.norm.weight                    	backbone.bottom_up.res2.2.conv3.norm.weight                 	
backbone.res2.res2c.branch2c.norm.bias                      	backbone.bottom_up.res2.2.conv3.norm.bias                   	
backbone.res2.res2c.branch2c.norm._mean                     	backbone.bottom_up.res2.2.conv3.norm.running_mean           	
backbone.res2.res2c.branch2c.norm._variance                 	backbone.bottom_up.res2.2.conv3.norm.running_var            	
backbone.res3.res3a.branch2a.conv.weight                    	backbone.bottom_up.res3.0.conv1.weight                      	
backbone.res3.res3a.branch2a.norm.weight                    	backbone.bottom_up.res3.0.conv1.norm.weight                 	
backbone.res3.res3a.branch2a.norm.bias                      	backbone.bottom_up.res3.0.conv1.norm.bias                   	
backbone.res3.res3a.branch2a.norm._mean                     	backbone.bottom_up.res3.0.conv1.norm.running_mean           	
backbone.res3.res3a.branch2a.norm._variance                 	backbone.bottom_up.res3.0.conv1.norm.running_var            	
backbone.res3.res3a.branch2b.conv.weight                    	backbone.bottom_up.res3.0.conv2.weight                      	
backbone.res3.res3a.branch2b.norm.weight                    	backbone.bottom_up.res3.0.conv2.norm.weight                 	
backbone.res3.res3a.branch2b.norm.bias                      	backbone.bottom_up.res3.0.conv2.norm.bias                   	
backbone.res3.res3a.branch2b.norm._mean                     	backbone.bottom_up.res3.0.conv2.norm.running_mean           	
backbone.res3.res3a.branch2b.norm._variance                 	backbone.bottom_up.res3.0.conv2.norm.running_var            	
backbone.res3.res3a.branch2c.conv.weight                    	backbone.bottom_up.res3.0.conv3.weight                      	
backbone.res3.res3a.branch2c.norm.weight                    	backbone.bottom_up.res3.0.conv3.norm.weight                 	
backbone.res3.res3a.branch2c.norm.bias                      	backbone.bottom_up.res3.0.conv3.norm.bias                   	
backbone.res3.res3a.branch2c.norm._mean                     	backbone.bottom_up.res3.0.conv3.norm.running_mean           	
backbone.res3.res3a.branch2c.norm._variance                 	backbone.bottom_up.res3.0.conv3.norm.running_var            	
backbone.res3.res3a.short.conv.weight                       	backbone.bottom_up.res3.0.shortcut.weight                   	
backbone.res3.res3a.short.norm.weight                       	backbone.bottom_up.res3.0.shortcut.norm.weight              	
backbone.res3.res3a.short.norm.bias                         	backbone.bottom_up.res3.0.shortcut.norm.bias                	
backbone.res3.res3a.short.norm._mean                        	backbone.bottom_up.res3.0.shortcut.norm.running_mean        	
backbone.res3.res3a.short.norm._variance                    	backbone.bottom_up.res3.0.shortcut.norm.running_var         	
backbone.res3.res3b.branch2a.conv.weight                    	backbone.bottom_up.res3.1.conv1.weight                      	
backbone.res3.res3b.branch2a.norm.weight                    	backbone.bottom_up.res3.1.conv1.norm.weight                 	
backbone.res3.res3b.branch2a.norm.bias                      	backbone.bottom_up.res3.1.conv1.norm.bias                   	
backbone.res3.res3b.branch2a.norm._mean                     	backbone.bottom_up.res3.1.conv1.norm.running_mean           	
backbone.res3.res3b.branch2a.norm._variance                 	backbone.bottom_up.res3.1.conv1.norm.running_var            	
backbone.res3.res3b.branch2b.conv.weight                    	backbone.bottom_up.res3.1.conv2.weight                      	
backbone.res3.res3b.branch2b.norm.weight                    	backbone.bottom_up.res3.1.conv2.norm.weight                 	
backbone.res3.res3b.branch2b.norm.bias                      	backbone.bottom_up.res3.1.conv2.norm.bias                   	
backbone.res3.res3b.branch2b.norm._mean                     	backbone.bottom_up.res3.1.conv2.norm.running_mean           	
backbone.res3.res3b.branch2b.norm._variance                 	backbone.bottom_up.res3.1.conv2.norm.running_var            	
backbone.res3.res3b.branch2c.conv.weight                    	backbone.bottom_up.res3.1.conv3.weight                      	
backbone.res3.res3b.branch2c.norm.weight                    	backbone.bottom_up.res3.1.conv3.norm.weight                 	
backbone.res3.res3b.branch2c.norm.bias                      	backbone.bottom_up.res3.1.conv3.norm.bias                   	
backbone.res3.res3b.branch2c.norm._mean                     	backbone.bottom_up.res3.1.conv3.norm.running_mean           	
backbone.res3.res3b.branch2c.norm._variance                 	backbone.bottom_up.res3.1.conv3.norm.running_var            	
backbone.res3.res3c.branch2a.conv.weight                    	backbone.bottom_up.res3.2.conv1.weight                      	
backbone.res3.res3c.branch2a.norm.weight                    	backbone.bottom_up.res3.2.conv1.norm.weight                 	
backbone.res3.res3c.branch2a.norm.bias                      	backbone.bottom_up.res3.2.conv1.norm.bias                   	
backbone.res3.res3c.branch2a.norm._mean                     	backbone.bottom_up.res3.2.conv1.norm.running_mean           	
backbone.res3.res3c.branch2a.norm._variance                 	backbone.bottom_up.res3.2.conv1.norm.running_var            	
backbone.res3.res3c.branch2b.conv.weight                    	backbone.bottom_up.res3.2.conv2.weight                      	
backbone.res3.res3c.branch2b.norm.weight                    	backbone.bottom_up.res3.2.conv2.norm.weight                 	
backbone.res3.res3c.branch2b.norm.bias                      	backbone.bottom_up.res3.2.conv2.norm.bias                   	
backbone.res3.res3c.branch2b.norm._mean                     	backbone.bottom_up.res3.2.conv2.norm.running_mean           	
backbone.res3.res3c.branch2b.norm._variance                 	backbone.bottom_up.res3.2.conv2.norm.running_var            	
backbone.res3.res3c.branch2c.conv.weight                    	backbone.bottom_up.res3.2.conv3.weight                      	
backbone.res3.res3c.branch2c.norm.weight                    	backbone.bottom_up.res3.2.conv3.norm.weight                 	
backbone.res3.res3c.branch2c.norm.bias                      	backbone.bottom_up.res3.2.conv3.norm.bias                   	
backbone.res3.res3c.branch2c.norm._mean                     	backbone.bottom_up.res3.2.conv3.norm.running_mean           	
backbone.res3.res3c.branch2c.norm._variance                 	backbone.bottom_up.res3.2.conv3.norm.running_var            	
backbone.res3.res3d.branch2a.conv.weight                    	backbone.bottom_up.res3.3.conv1.weight                      	
backbone.res3.res3d.branch2a.norm.weight                    	backbone.bottom_up.res3.3.conv1.norm.weight                 	
backbone.res3.res3d.branch2a.norm.bias                      	backbone.bottom_up.res3.3.conv1.norm.bias                   	
backbone.res3.res3d.branch2a.norm._mean                     	backbone.bottom_up.res3.3.conv1.norm.running_mean           	
backbone.res3.res3d.branch2a.norm._variance                 	backbone.bottom_up.res3.3.conv1.norm.running_var            	
backbone.res3.res3d.branch2b.conv.weight                    	backbone.bottom_up.res3.3.conv2.weight                      	
backbone.res3.res3d.branch2b.norm.weight                    	backbone.bottom_up.res3.3.conv2.norm.weight                 	
backbone.res3.res3d.branch2b.norm.bias                      	backbone.bottom_up.res3.3.conv2.norm.bias                   	
backbone.res3.res3d.branch2b.norm._mean                     	backbone.bottom_up.res3.3.conv2.norm.running_mean           	
backbone.res3.res3d.branch2b.norm._variance                 	backbone.bottom_up.res3.3.conv2.norm.running_var            	
backbone.res3.res3d.branch2c.conv.weight                    	backbone.bottom_up.res3.3.conv3.weight                      	
backbone.res3.res3d.branch2c.norm.weight                    	backbone.bottom_up.res3.3.conv3.norm.weight                 	
backbone.res3.res3d.branch2c.norm.bias                      	backbone.bottom_up.res3.3.conv3.norm.bias                   	
backbone.res3.res3d.branch2c.norm._mean                     	backbone.bottom_up.res3.3.conv3.norm.running_mean           	
backbone.res3.res3d.branch2c.norm._variance                 	backbone.bottom_up.res3.3.conv3.norm.running_var            	
backbone.res4.res4a.branch2a.conv.weight                    	backbone.bottom_up.res4.0.conv1.weight                      	
backbone.res4.res4a.branch2a.norm.weight                    	backbone.bottom_up.res4.0.conv1.norm.weight                 	
backbone.res4.res4a.branch2a.norm.bias                      	backbone.bottom_up.res4.0.conv1.norm.bias                   	
backbone.res4.res4a.branch2a.norm._mean                     	backbone.bottom_up.res4.0.conv1.norm.running_mean           	
backbone.res4.res4a.branch2a.norm._variance                 	backbone.bottom_up.res4.0.conv1.norm.running_var            	
backbone.res4.res4a.branch2b.conv.weight                    	backbone.bottom_up.res4.0.conv2.weight                      	
backbone.res4.res4a.branch2b.norm.weight                    	backbone.bottom_up.res4.0.conv2.norm.weight                 	
backbone.res4.res4a.branch2b.norm.bias                      	backbone.bottom_up.res4.0.conv2.norm.bias                   	
backbone.res4.res4a.branch2b.norm._mean                     	backbone.bottom_up.res4.0.conv2.norm.running_mean           	
backbone.res4.res4a.branch2b.norm._variance                 	backbone.bottom_up.res4.0.conv2.norm.running_var            	
backbone.res4.res4a.branch2c.conv.weight                    	backbone.bottom_up.res4.0.conv3.weight                      	
backbone.res4.res4a.branch2c.norm.weight                    	backbone.bottom_up.res4.0.conv3.norm.weight                 	
backbone.res4.res4a.branch2c.norm.bias                      	backbone.bottom_up.res4.0.conv3.norm.bias                   	
backbone.res4.res4a.branch2c.norm._mean                     	backbone.bottom_up.res4.0.conv3.norm.running_mean           	
backbone.res4.res4a.branch2c.norm._variance                 	backbone.bottom_up.res4.0.conv3.norm.running_var            	
backbone.res4.res4a.short.conv.weight                       	backbone.bottom_up.res4.0.shortcut.weight                   	
backbone.res4.res4a.short.norm.weight                       	backbone.bottom_up.res4.0.shortcut.norm.weight              	
backbone.res4.res4a.short.norm.bias                         	backbone.bottom_up.res4.0.shortcut.norm.bias                	
backbone.res4.res4a.short.norm._mean                        	backbone.bottom_up.res4.0.shortcut.norm.running_mean        	
backbone.res4.res4a.short.norm._variance                    	backbone.bottom_up.res4.0.shortcut.norm.running_var         	
backbone.res4.res4b.branch2a.conv.weight                    	backbone.bottom_up.res4.1.conv1.weight                      	
backbone.res4.res4b.branch2a.norm.weight                    	backbone.bottom_up.res4.1.conv1.norm.weight                 	
backbone.res4.res4b.branch2a.norm.bias                      	backbone.bottom_up.res4.1.conv1.norm.bias                   	
backbone.res4.res4b.branch2a.norm._mean                     	backbone.bottom_up.res4.1.conv1.norm.running_mean           	
backbone.res4.res4b.branch2a.norm._variance                 	backbone.bottom_up.res4.1.conv1.norm.running_var            	
backbone.res4.res4b.branch2b.conv.weight                    	backbone.bottom_up.res4.1.conv2.weight                      	
backbone.res4.res4b.branch2b.norm.weight                    	backbone.bottom_up.res4.1.conv2.norm.weight                 	
backbone.res4.res4b.branch2b.norm.bias                      	backbone.bottom_up.res4.1.conv2.norm.bias                   	
backbone.res4.res4b.branch2b.norm._mean                     	backbone.bottom_up.res4.1.conv2.norm.running_mean           	
backbone.res4.res4b.branch2b.norm._variance                 	backbone.bottom_up.res4.1.conv2.norm.running_var            	
backbone.res4.res4b.branch2c.conv.weight                    	backbone.bottom_up.res4.1.conv3.weight                      	
backbone.res4.res4b.branch2c.norm.weight                    	backbone.bottom_up.res4.1.conv3.norm.weight                 	
backbone.res4.res4b.branch2c.norm.bias                      	backbone.bottom_up.res4.1.conv3.norm.bias                   	
backbone.res4.res4b.branch2c.norm._mean                     	backbone.bottom_up.res4.1.conv3.norm.running_mean           	
backbone.res4.res4b.branch2c.norm._variance                 	backbone.bottom_up.res4.1.conv3.norm.running_var            	
backbone.res4.res4c.branch2a.conv.weight                    	backbone.bottom_up.res4.2.conv1.weight                      	
backbone.res4.res4c.branch2a.norm.weight                    	backbone.bottom_up.res4.2.conv1.norm.weight                 	
backbone.res4.res4c.branch2a.norm.bias                      	backbone.bottom_up.res4.2.conv1.norm.bias                   	
backbone.res4.res4c.branch2a.norm._mean                     	backbone.bottom_up.res4.2.conv1.norm.running_mean           	
backbone.res4.res4c.branch2a.norm._variance                 	backbone.bottom_up.res4.2.conv1.norm.running_var            	
backbone.res4.res4c.branch2b.conv.weight                    	backbone.bottom_up.res4.2.conv2.weight                      	
backbone.res4.res4c.branch2b.norm.weight                    	backbone.bottom_up.res4.2.conv2.norm.weight                 	
backbone.res4.res4c.branch2b.norm.bias                      	backbone.bottom_up.res4.2.conv2.norm.bias                   	
backbone.res4.res4c.branch2b.norm._mean                     	backbone.bottom_up.res4.2.conv2.norm.running_mean           	
backbone.res4.res4c.branch2b.norm._variance                 	backbone.bottom_up.res4.2.conv2.norm.running_var            	
backbone.res4.res4c.branch2c.conv.weight                    	backbone.bottom_up.res4.2.conv3.weight                      	
backbone.res4.res4c.branch2c.norm.weight                    	backbone.bottom_up.res4.2.conv3.norm.weight                 	
backbone.res4.res4c.branch2c.norm.bias                      	backbone.bottom_up.res4.2.conv3.norm.bias                   	
backbone.res4.res4c.branch2c.norm._mean                     	backbone.bottom_up.res4.2.conv3.norm.running_mean           	
backbone.res4.res4c.branch2c.norm._variance                 	backbone.bottom_up.res4.2.conv3.norm.running_var            	
backbone.res4.res4d.branch2a.conv.weight                    	backbone.bottom_up.res4.3.conv1.weight                      	
backbone.res4.res4d.branch2a.norm.weight                    	backbone.bottom_up.res4.3.conv1.norm.weight                 	
backbone.res4.res4d.branch2a.norm.bias                      	backbone.bottom_up.res4.3.conv1.norm.bias                   	
backbone.res4.res4d.branch2a.norm._mean                     	backbone.bottom_up.res4.3.conv1.norm.running_mean           	
backbone.res4.res4d.branch2a.norm._variance                 	backbone.bottom_up.res4.3.conv1.norm.running_var            	
backbone.res4.res4d.branch2b.conv.weight                    	backbone.bottom_up.res4.3.conv2.weight                      	
backbone.res4.res4d.branch2b.norm.weight                    	backbone.bottom_up.res4.3.conv2.norm.weight                 	
backbone.res4.res4d.branch2b.norm.bias                      	backbone.bottom_up.res4.3.conv2.norm.bias                   	
backbone.res4.res4d.branch2b.norm._mean                     	backbone.bottom_up.res4.3.conv2.norm.running_mean           	
backbone.res4.res4d.branch2b.norm._variance                 	backbone.bottom_up.res4.3.conv2.norm.running_var            	
backbone.res4.res4d.branch2c.conv.weight                    	backbone.bottom_up.res4.3.conv3.weight                      	
backbone.res4.res4d.branch2c.norm.weight                    	backbone.bottom_up.res4.3.conv3.norm.weight                 	
backbone.res4.res4d.branch2c.norm.bias                      	backbone.bottom_up.res4.3.conv3.norm.bias                   	
backbone.res4.res4d.branch2c.norm._mean                     	backbone.bottom_up.res4.3.conv3.norm.running_mean           	
backbone.res4.res4d.branch2c.norm._variance                 	backbone.bottom_up.res4.3.conv3.norm.running_var            	
backbone.res4.res4e.branch2a.conv.weight                    	backbone.bottom_up.res4.4.conv1.weight                      	
backbone.res4.res4e.branch2a.norm.weight                    	backbone.bottom_up.res4.4.conv1.norm.weight                 	
backbone.res4.res4e.branch2a.norm.bias                      	backbone.bottom_up.res4.4.conv1.norm.bias                   	
backbone.res4.res4e.branch2a.norm._mean                     	backbone.bottom_up.res4.4.conv1.norm.running_mean           	
backbone.res4.res4e.branch2a.norm._variance                 	backbone.bottom_up.res4.4.conv1.norm.running_var            	
backbone.res4.res4e.branch2b.conv.weight                    	backbone.bottom_up.res4.4.conv2.weight                      	
backbone.res4.res4e.branch2b.norm.weight                    	backbone.bottom_up.res4.4.conv2.norm.weight                 	
backbone.res4.res4e.branch2b.norm.bias                      	backbone.bottom_up.res4.4.conv2.norm.bias                   	
backbone.res4.res4e.branch2b.norm._mean                     	backbone.bottom_up.res4.4.conv2.norm.running_mean           	
backbone.res4.res4e.branch2b.norm._variance                 	backbone.bottom_up.res4.4.conv2.norm.running_var            	
backbone.res4.res4e.branch2c.conv.weight                    	backbone.bottom_up.res4.4.conv3.weight                      	
backbone.res4.res4e.branch2c.norm.weight                    	backbone.bottom_up.res4.4.conv3.norm.weight                 	
backbone.res4.res4e.branch2c.norm.bias                      	backbone.bottom_up.res4.4.conv3.norm.bias                   	
backbone.res4.res4e.branch2c.norm._mean                     	backbone.bottom_up.res4.4.conv3.norm.running_mean           	
backbone.res4.res4e.branch2c.norm._variance                 	backbone.bottom_up.res4.4.conv3.norm.running_var            	
backbone.res4.res4f.branch2a.conv.weight                    	backbone.bottom_up.res4.5.conv1.weight                      	
backbone.res4.res4f.branch2a.norm.weight                    	backbone.bottom_up.res4.5.conv1.norm.weight                 	
backbone.res4.res4f.branch2a.norm.bias                      	backbone.bottom_up.res4.5.conv1.norm.bias                   	
backbone.res4.res4f.branch2a.norm._mean                     	backbone.bottom_up.res4.5.conv1.norm.running_mean           	
backbone.res4.res4f.branch2a.norm._variance                 	backbone.bottom_up.res4.5.conv1.norm.running_var            	
backbone.res4.res4f.branch2b.conv.weight                    	backbone.bottom_up.res4.5.conv2.weight                      	
backbone.res4.res4f.branch2b.norm.weight                    	backbone.bottom_up.res4.5.conv2.norm.weight                 	
backbone.res4.res4f.branch2b.norm.bias                      	backbone.bottom_up.res4.5.conv2.norm.bias                   	
backbone.res4.res4f.branch2b.norm._mean                     	backbone.bottom_up.res4.5.conv2.norm.running_mean           	
backbone.res4.res4f.branch2b.norm._variance                 	backbone.bottom_up.res4.5.conv2.norm.running_var            	
backbone.res4.res4f.branch2c.conv.weight                    	backbone.bottom_up.res4.5.conv3.weight                      	
backbone.res4.res4f.branch2c.norm.weight                    	backbone.bottom_up.res4.5.conv3.norm.weight                 	
backbone.res4.res4f.branch2c.norm.bias                      	backbone.bottom_up.res4.5.conv3.norm.bias                   	
backbone.res4.res4f.branch2c.norm._mean                     	backbone.bottom_up.res4.5.conv3.norm.running_mean           	
backbone.res4.res4f.branch2c.norm._variance                 	backbone.bottom_up.res4.5.conv3.norm.running_var            	
backbone.res5.res5a.branch2a.conv.weight                    	backbone.bottom_up.res5.0.conv1.weight                      	
backbone.res5.res5a.branch2a.norm.weight                    	backbone.bottom_up.res5.0.conv1.norm.weight                 	
backbone.res5.res5a.branch2a.norm.bias                      	backbone.bottom_up.res5.0.conv1.norm.bias                   	
backbone.res5.res5a.branch2a.norm._mean                     	backbone.bottom_up.res5.0.conv1.norm.running_mean           	
backbone.res5.res5a.branch2a.norm._variance                 	backbone.bottom_up.res5.0.conv1.norm.running_var            	
backbone.res5.res5a.branch2b.conv.weight                    	backbone.bottom_up.res5.0.conv2.weight                      	
backbone.res5.res5a.branch2b.norm.weight                    	backbone.bottom_up.res5.0.conv2.norm.weight                 	
backbone.res5.res5a.branch2b.norm.bias                      	backbone.bottom_up.res5.0.conv2.norm.bias                   	
backbone.res5.res5a.branch2b.norm._mean                     	backbone.bottom_up.res5.0.conv2.norm.running_mean           	
backbone.res5.res5a.branch2b.norm._variance                 	backbone.bottom_up.res5.0.conv2.norm.running_var            	
backbone.res5.res5a.branch2c.conv.weight                    	backbone.bottom_up.res5.0.conv3.weight                      	
backbone.res5.res5a.branch2c.norm.weight                    	backbone.bottom_up.res5.0.conv3.norm.weight                 	
backbone.res5.res5a.branch2c.norm.bias                      	backbone.bottom_up.res5.0.conv3.norm.bias                   	
backbone.res5.res5a.branch2c.norm._mean                     	backbone.bottom_up.res5.0.conv3.norm.running_mean           	
backbone.res5.res5a.branch2c.norm._variance                 	backbone.bottom_up.res5.0.conv3.norm.running_var            	
backbone.res5.res5a.short.conv.weight                       	backbone.bottom_up.res5.0.shortcut.weight                   	
backbone.res5.res5a.short.norm.weight                       	backbone.bottom_up.res5.0.shortcut.norm.weight              	
backbone.res5.res5a.short.norm.bias                         	backbone.bottom_up.res5.0.shortcut.norm.bias                	
backbone.res5.res5a.short.norm._mean                        	backbone.bottom_up.res5.0.shortcut.norm.running_mean        	
backbone.res5.res5a.short.norm._variance                    	backbone.bottom_up.res5.0.shortcut.norm.running_var         	
backbone.res5.res5b.branch2a.conv.weight                    	backbone.bottom_up.res5.1.conv1.weight                      	
backbone.res5.res5b.branch2a.norm.weight                    	backbone.bottom_up.res5.1.conv1.norm.weight                 	
backbone.res5.res5b.branch2a.norm.bias                      	backbone.bottom_up.res5.1.conv1.norm.bias                   	
backbone.res5.res5b.branch2a.norm._mean                     	backbone.bottom_up.res5.1.conv1.norm.running_mean           	
backbone.res5.res5b.branch2a.norm._variance                 	backbone.bottom_up.res5.1.conv1.norm.running_var            	
backbone.res5.res5b.branch2b.conv.weight                    	backbone.bottom_up.res5.1.conv2.weight                      	
backbone.res5.res5b.branch2b.norm.weight                    	backbone.bottom_up.res5.1.conv2.norm.weight                 	
backbone.res5.res5b.branch2b.norm.bias                      	backbone.bottom_up.res5.1.conv2.norm.bias                   	
backbone.res5.res5b.branch2b.norm._mean                     	backbone.bottom_up.res5.1.conv2.norm.running_mean           	
backbone.res5.res5b.branch2b.norm._variance                 	backbone.bottom_up.res5.1.conv2.norm.running_var            	
backbone.res5.res5b.branch2c.conv.weight                    	backbone.bottom_up.res5.1.conv3.weight                      	
backbone.res5.res5b.branch2c.norm.weight                    	backbone.bottom_up.res5.1.conv3.norm.weight                 	
backbone.res5.res5b.branch2c.norm.bias                      	backbone.bottom_up.res5.1.conv3.norm.bias                   	
backbone.res5.res5b.branch2c.norm._mean                     	backbone.bottom_up.res5.1.conv3.norm.running_mean           	
backbone.res5.res5b.branch2c.norm._variance                 	backbone.bottom_up.res5.1.conv3.norm.running_var            	
backbone.res5.res5c.branch2a.conv.weight                    	backbone.bottom_up.res5.2.conv1.weight                      	
backbone.res5.res5c.branch2a.norm.weight                    	backbone.bottom_up.res5.2.conv1.norm.weight                 	
backbone.res5.res5c.branch2a.norm.bias                      	backbone.bottom_up.res5.2.conv1.norm.bias                   	
backbone.res5.res5c.branch2a.norm._mean                     	backbone.bottom_up.res5.2.conv1.norm.running_mean           	
backbone.res5.res5c.branch2a.norm._variance                 	backbone.bottom_up.res5.2.conv1.norm.running_var            	
backbone.res5.res5c.branch2b.conv.weight                    	backbone.bottom_up.res5.2.conv2.weight                      	
backbone.res5.res5c.branch2b.norm.weight                    	backbone.bottom_up.res5.2.conv2.norm.weight                 	
backbone.res5.res5c.branch2b.norm.bias                      	backbone.bottom_up.res5.2.conv2.norm.bias                   	
backbone.res5.res5c.branch2b.norm._mean                     	backbone.bottom_up.res5.2.conv2.norm.running_mean           	
backbone.res5.res5c.branch2b.norm._variance                 	backbone.bottom_up.res5.2.conv2.norm.running_var            	
backbone.res5.res5c.branch2c.conv.weight                    	backbone.bottom_up.res5.2.conv3.weight                      	
backbone.res5.res5c.branch2c.norm.weight                    	backbone.bottom_up.res5.2.conv3.norm.weight                 	
backbone.res5.res5c.branch2c.norm.bias                      	backbone.bottom_up.res5.2.conv3.norm.bias                   	
backbone.res5.res5c.branch2c.norm._mean                     	backbone.bottom_up.res5.2.conv3.norm.running_mean           	
backbone.res5.res5c.branch2c.norm._variance                 	backbone.bottom_up.res5.2.conv3.norm.running_var            	
rpn_head.rpn_feat.rpn_conv.weight                           	proposal_generator.rpn_head.conv.weight                     	
rpn_head.rpn_feat.rpn_conv.bias                             	proposal_generator.rpn_head.conv.bias                       	
rpn_head.rpn_rois_score.weight                              	proposal_generator.rpn_head.objectness_logits.weight        	
rpn_head.rpn_rois_score.bias                                	proposal_generator.rpn_head.objectness_logits.bias          	
rpn_head.rpn_rois_delta.weight                              	proposal_generator.rpn_head.anchor_deltas.weight            	
rpn_head.rpn_rois_delta.bias                                	proposal_generator.rpn_head.anchor_deltas.bias              	
bbox_head.head.0.fc6.weight                                 	roi_heads.box_head.0.fc1.weight                             	
bbox_head.head.0.fc6.bias                                   	roi_heads.box_head.0.fc1.bias                               	
bbox_head.head.0.fc7.weight                                 	roi_heads.box_head.0.fc2.weight                             	
bbox_head.head.0.fc7.bias                                   	roi_heads.box_head.0.fc2.bias                               	
bbox_head.head.1.fc6.weight                                 	roi_heads.box_head.1.fc1.weight                             	
bbox_head.head.1.fc6.bias                                   	roi_heads.box_head.1.fc1.bias                               	
bbox_head.head.1.fc7.weight                                 	roi_heads.box_head.1.fc2.weight                             	
bbox_head.head.1.fc7.bias                                   	roi_heads.box_head.1.fc2.bias                               	
bbox_head.head.2.fc6.weight                                 	roi_heads.box_head.2.fc1.weight                             	
bbox_head.head.2.fc6.bias                                   	roi_heads.box_head.2.fc1.bias                               	
bbox_head.head.2.fc7.weight                                 	roi_heads.box_head.2.fc2.weight                             	
bbox_head.head.2.fc7.bias                                   	roi_heads.box_head.2.fc2.bias                               	
bbox_head.bbox_score_stage0.weight                          	roi_heads.box_predictor.0.cls_score.weight                  	
bbox_head.bbox_score_stage0.bias                            	roi_heads.box_predictor.0.cls_score.bias                    	
bbox_head.bbox_delta_stage0.weight                          	roi_heads.box_predictor.0.bbox_pred.weight                  	
bbox_head.bbox_delta_stage0.bias                            	roi_heads.box_predictor.0.bbox_pred.bias                    	
bbox_head.bbox_score_stage1.weight                          	roi_heads.box_predictor.1.cls_score.weight                  	
bbox_head.bbox_score_stage1.bias                            	roi_heads.box_predictor.1.cls_score.bias                    	
bbox_head.bbox_delta_stage1.weight                          	roi_heads.box_predictor.1.bbox_pred.weight                  	
bbox_head.bbox_delta_stage1.bias                            	roi_heads.box_predictor.1.bbox_pred.bias                    	
bbox_head.bbox_score_stage2.weight                          	roi_heads.box_predictor.2.cls_score.weight                  	
bbox_head.bbox_score_stage2.bias                            	roi_heads.box_predictor.2.cls_score.bias                    	
bbox_head.bbox_delta_stage2.weight                          	roi_heads.box_predictor.2.bbox_pred.weight                  	
bbox_head.bbox_delta_stage2.bias                            	roi_heads.box_predictor.2.bbox_pred.bias                    	
neck.fpn_inner_res3_sum_lateral.weight                      	backbone.fpn_lateral3.weight                                	
neck.fpn_inner_res3_sum_lateral.bias                        	backbone.fpn_lateral3.bias                                  	
neck.fpn_res3_sum.weight                                    	backbone.fpn_output3.weight                                 	
neck.fpn_res3_sum.bias                                      	backbone.fpn_output3.bias                                   	
neck.fpn_inner_res4_sum_lateral.weight                      	backbone.fpn_lateral4.weight                                	
neck.fpn_inner_res4_sum_lateral.bias                        	backbone.fpn_lateral4.bias                                  	
neck.fpn_res4_sum.weight                                    	backbone.fpn_output4.weight                                 	
neck.fpn_res4_sum.bias                                      	backbone.fpn_output4.bias                                   	
neck.fpn_inner_res5_sum.weight                              	backbone.fpn_lateral5.weight                                	
neck.fpn_inner_res5_sum.bias                                	backbone.fpn_lateral5.bias                                  	
neck.fpn_res5_sum.weight                                    	backbone.fpn_output5.weight                                 	
neck.fpn_res5_sum.bias                                      	backbone.fpn_output5.bias                                   	
neck.fpn_6.weight                                           	backbone.top_block.p6.weight                                	
neck.fpn_6.bias                                             	backbone.top_block.p6.bias                                  	
neck.fpn_7.weight                                           	backbone.top_block.p7.weight                                	
neck.fpn_7.bias                                             	backbone.top_block.p7.bias                                  	
